[
   {
        "id": 1,
        "tilesize": 32,
        "tilemap": [
            ["x","x","x","x","x","x","x","x","x","x","x","x","x","x","x","x","x","x","x","x","x","x","x","x","x","x","x","x","x","x"],
            ["x","o","o","x","o","x","o","o","o","o","o","o","o","o","o","o","o","o","o","o","o","o","o","o","o","o","o","o","o","x"],
            ["x","o","o","x","o","x","o","o","o","o","o","o","o","o","o","o","o","o","o","o","o","o","o","o","o","o","o","o","o","x"],
            ["x","o","o","x","o","x","o","o","o","o","o","o","o","o","o","o","o","o","o","o","o","o","o","o","o","o","o","o","o","x"],
            ["x","o","o","x","o","x","o","o","o","o","o","o","o","o","o","o","o","o","o","o","o","o","o","o","o","o","o","o","o","x"],
            ["x","o","o","x","o","x","o","o","o","o","o","o","o","o","o","o","o","o","o","o","o","o","o","o","o","o","o","o","o","x"],
            ["x","o","o","x","o","x","o","o","o","o","o","o","o","o","o","o","o","o","o","o","o","o","o","o","o","o","o","o","o","x"],
            ["x","o","o","x","o","x","o","o","o","o","o","o","o","o","o","o","o","o","o","o","o","o","o","o","o","o","o","o","o","x"],
            ["x","o","o","x","x","x","o","o","o","o","o","o","o","o","o","o","o","o","o","o","o","o","o","o","o","o","o","o","o","x"],
            ["x","o","o","o","o","o","o","o","o","o","o","o","o","o","o","o","o","o","o","o","o","o","o","o","o","o","o","o","o","x"],
            ["x","o","o","o","o","o","o","o","o","o","o","o","o","o","o","o","o","o","o","o","o","o","o","o","o","o","o","o","o","x"],
            ["x","o","o","o","o","o","o","o","o","o","o","o","o","o","o","o","o","o","o","o","o","o","o","o","o","o","o","o","o","x"],
            ["x","o","o","o","o","o","o","o","o","o","o","o","o","o","o","o","o","o","o","o","o","o","o","o","o","o","o","o","o","x"],
            ["x","o","o","o","o","o","o","o","o","o","o","o","o","o","o","o","o","o","o","o","o","o","o","o","o","o","o","o","o","x"],
            ["x","o","o","o","o","o","o","o","o","o","o","o","o","o","o","o","o","o","o","o","o","o","o","o","o","o","o","o","o","x"],
            ["x","o","o","o","o","o","o","o","o","o","o","o","o","o","o","o","o","o","o","o","o","o","o","o","o","o","o","o","o","x"],
            ["x","o","o","o","o","o","o","o","o","o","o","o","o","o","o","o","o","o","o","o","o","o","o","o","o","o","o","o","o","x"],
            ["x","o","o","o","o","o","o","o","o","o","o","o","o","o","o","o","o","o","o","o","o","o","o","o","o","o","o","o","o","x"],
            ["x","o","o","o","o","o","o","o","o","o","o","o","o","o","o","o","o","o","o","o","o","o","o","o","o","o","o","o","o","x"],
            ["x","o","o","o","o","o","o","o","o","o","o","o","o","o","o","o","o","o","o","o","o","o","o","o","o","o","o","o","o","x"],
            ["x","o","o","o","o","o","o","o","o","o","o","o","o","o","o","o","o","o","o","o","o","o","o","o","o","o","o","o","o","x"],
            ["x","o","o","o","o","o","o","o","o","o","o","o","o","o","o","o","o","o","o","o","o","o","o","o","o","o","o","o","o","x"],
            ["x","o","o","o","o","o","o","o","o","o","o","o","o","o","o","o","o","o","o","o","o","o","o","o","o","o","o","o","o","x"],
            ["x","o","o","o","o","o","o","o","o","o","o","o","o","o","o","o","o","o","o","o","o","o","o","o","o","o","o","o","o","x"],
            ["x","o","o","o","o","o","o","o","o","o","o","o","o","o","o","o","o","o","o","o","o","o","o","o","o","o","o","o","o","x"],
            ["x","x","x","x","x","x","x","x","x","x","x","x","x","x","x","x","x","x","x","x","x","x","x","x","x","x","x","x","x","x"]
        ] 
    }
]


