[
   {
        "level": 1,
        "tile-map": [
            ["x","x","x","x","x","x","x","x","x","x","x","x","x","x","x","x","x","x","x","x","x","x","x","x","x","x","x","x","x","x"],
            ["x"," "," ","x"," ","x"," "," "," "," "," "," "," "," "," "," "," "," "," "," "," "," "," "," "," "," "," "," "," ","x"],
            ["x"," "," ","x"," ","x"," "," "," "," "," "," "," "," "," "," "," "," "," "," "," "," "," "," "," "," "," "," "," ","x"],
            ["x"," "," ","x"," ","x"," "," "," "," "," "," "," "," "," "," "," "," "," "," "," "," "," "," "," "," "," "," "," ","x"],
            ["x"," "," ","x"," ","x"," "," "," ","e"," "," "," "," "," "," "," "," "," "," "," "," "," "," "," "," "," "," "," ","x"],
            ["x"," "," ","x"," ","x"," ","e"," "," "," "," "," "," "," "," "," "," "," "," "," "," "," "," "," "," "," "," "," ","x"],
            ["x"," "," ","x"," ","x"," "," ","e"," "," "," "," "," "," "," "," "," "," "," "," "," "," "," "," "," "," "," "," ","x"],
            ["x"," "," ","x"," ","x"," "," "," "," "," "," "," "," "," "," "," "," "," "," "," "," "," "," "," "," "," "," "," ","x"],
            ["x"," "," ","x","x","x"," "," "," "," "," "," "," "," "," "," "," "," "," "," "," "," "," "," "," "," "," "," "," ","x"],
            ["x"," "," "," "," "," "," "," ","e"," "," "," "," "," "," "," "," ","2"," "," "," "," "," "," "," "," "," "," "," ","x"],
            ["x"," "," "," "," "," "," "," "," "," "," "," "," "," "," "," "," "," "," "," "," "," "," "," "," "," "," "," "," ","x"],
            ["x"," "," "," "," "," "," "," "," "," "," "," "," "," "," "," "," "," "," "," "," "," "," "," "," "," "," "," "," ","x"],
            ["x"," "," "," "," "," ","p"," "," "," "," "," "," "," "," "," "," "," "," "," "," "," "," "," "," "," "," "," "," ","x"],
            ["x"," "," "," "," "," "," "," "," "," "," "," "," "," "," "," "," "," "," "," "," "," "," "," "," "," "," "," "," ","x"],
            ["x"," "," "," "," "," "," "," "," "," "," "," "," "," "," "," "," "," "," "," "," "," "," "," "," "," "," "," "," ","x"],
            ["x"," "," "," "," "," "," "," "," "," "," "," "," "," "," "," "," "," "," "," "," "," "," "," "," "," "," "," "," ","x"],
            ["x"," "," "," "," "," "," "," "," "," "," "," "," "," "," "," "," "," "," "," "," "," "," "," "," "," "," "," "," ","x"],
            ["x"," "," "," "," "," "," "," "," "," "," "," "," "," "," "," "," "," "," "," "," "," "," "," "," "," "," "," "," ","x"],
            ["x"," "," "," "," "," "," "," "," "," "," "," "," "," "," "," "," "," "," "," "," "," "," "," "," "," "," "," "," ","x"],
            ["x"," "," "," "," "," "," "," "," "," "," "," "," "," "," "," "," "," "," "," "," "," "," "," "," "," "," "," "," ","x"],
            ["x"," "," "," "," "," "," "," "," "," "," "," "," "," "," "," "," "," "," "," "," "," "," "," "," "," "," "," "," ","x"],
            ["x"," "," "," "," "," "," "," "," "," "," "," "," "," "," "," "," "," "," "," "," "," "," "," "," "," "," "," "," ","x"],
            ["x"," "," "," "," "," "," "," "," "," "," "," "," "," "," "," "," "," "," "," "," "," "," "," "," "," "," "," "," ","x"],
            ["x"," "," "," "," "," "," "," "," "," "," "," "," "," "," "," "," "," "," "," "," "," "," "," "," "," "," "," "," ","x"],
            ["x"," "," "," "," "," "," "," "," "," "," "," "," "," "," "," "," "," "," "," "," "," "," "," "," "," "," "," "," ","x"],
            ["x","x","x","x","x","x","x","x","x","x","x","x","x","x","x","x","x","x","x","x","x","x","x","x","x","x","x","x","x","x"]
        ] 
    },
    {
        "level": 2,
        "tile-map": [
            ["x","x","x","x","x","x","x","x","x","x","x","x","x","x","x","x","x","x","x","x","x","x","x","x","x","x","x","x","x","x"],
            ["x"," "," ","x"," ","x"," "," "," "," "," "," "," "," "," ","x"," "," "," "," "," "," "," "," "," "," "," "," "," ","x"],
            ["x"," "," ","x"," ","x"," "," "," "," "," "," "," "," "," ","x"," "," "," "," "," "," "," "," "," "," "," "," "," ","x"],
            ["x"," "," ","x"," ","x"," ","p"," "," "," "," "," "," "," ","x"," "," "," "," "," "," "," "," "," "," "," "," "," ","x"],
            ["x"," "," ","x"," ","x"," "," "," "," "," "," "," "," "," ","x"," "," "," "," "," "," "," "," "," "," "," "," "," ","x"],
            ["x"," "," ","x"," ","x"," "," "," "," "," "," "," "," "," ","x"," "," "," "," "," "," "," "," "," "," "," "," "," ","x"],
            ["x"," "," ","x"," ","x"," "," "," "," "," "," "," "," "," ","x"," "," "," "," "," "," "," "," "," "," "," "," "," ","x"],
            ["x"," "," ","x"," ","x"," "," "," "," "," "," "," "," "," ","x"," "," "," "," "," "," "," "," "," "," "," "," "," ","x"],
            ["x"," "," ","x","x","x","x","x","x","x","x"," "," ","x","x","x"," "," "," "," "," "," "," "," "," "," "," "," "," ","x"],
            ["x"," "," "," "," "," "," "," "," "," "," "," "," "," "," "," "," "," ","1"," "," "," "," "," "," "," "," "," "," ","x"],
            ["x"," "," "," "," "," "," "," "," "," "," "," "," "," "," "," "," "," "," "," "," "," "," "," "," "," "," "," "," ","x"],
            ["x"," "," "," "," "," "," "," "," "," "," "," "," "," "," "," "," "," "," "," "," "," "," "," "," "," "," "," "," ","x"],
            ["x"," "," "," "," "," "," "," "," "," "," "," "," "," "," "," "," "," "," "," "," "," "," "," "," "," "," "," "," ","x"],
            ["x"," "," "," "," "," "," "," "," "," "," "," "," "," "," "," "," "," "," "," "," "," "," "," "," "," "," "," "," ","x"],
            ["x"," "," "," "," "," "," "," "," "," "," "," "," "," "," "," "," "," "," "," "," "," "," "," "," "," "," "," "," ","x"],
            ["x"," "," "," "," "," "," "," "," "," "," "," "," "," "," "," "," "," "," "," "," "," "," "," "," "," "," "," "," ","x"],
            ["x"," "," "," "," "," "," "," "," ","e"," "," "," "," "," "," "," "," "," "," "," "," "," "," "," "," "," "," "," ","x"],
            ["x"," "," "," "," "," "," "," "," "," "," "," "," "," "," "," "," "," "," "," "," "," "," "," "," "," "," "," "," ","x"],
            ["x"," "," "," "," "," "," ","e","e"," "," "," "," "," "," "," "," "," "," "," "," "," "," "," "," "," "," "," "," ","x"],
            ["x"," "," "," "," "," "," "," "," "," "," "," "," "," "," "," "," "," "," "," "," "," "," "," "," "," "," "," "," ","x"],
            ["x"," "," "," "," "," "," "," "," "," "," "," "," "," "," "," "," "," "," "," "," "," "," "," "," "," "," "," "," ","x"],
            ["x"," "," "," "," "," "," "," "," "," "," "," "," "," "," "," "," "," "," "," "," "," "," "," "," "," "," "," "," ","x"],
            ["x"," "," "," "," "," "," "," "," "," "," "," "," "," "," ","s"," "," "," "," "," "," "," "," "," "," "," "," "," ","x"],
            ["x"," "," "," "," "," "," "," "," "," "," "," "," "," "," "," "," "," "," "," "," "," "," "," "," "," "," "," "," ","x"],
            ["x"," "," "," "," "," "," "," "," "," "," "," "," "," "," "," "," "," "," "," "," "," "," "," "," "," "," "," "," ","x"],
            ["x","x","x","x","x","x","x","x","x","x","x","x","x","x","x","x","x","x","x","x","x","x","x","x","x","x","x","x","x","x"]
        ] 
    }
]


