[
   {
        "level": 1,
        "tile-map": [
            ["x","x","x","x","x","x","x","x","x","x","x","x","x","x","x","x","x","x","x","x","x","x","x","x","x","x","x","x","x","x"],
            ["x"," "," ","x","x","x"," "," "," "," "," "," "," "," "," "," "," "," "," "," "," "," "," "," "," "," "," "," "," ","x"],
            ["x"," "," ","x","x","x"," "," "," "," "," "," "," "," "," "," "," "," "," "," "," "," "," "," "," "," "," "," "," ","x"],
            ["x","p"," ","x","x","x"," "," "," "," "," "," "," "," "," "," "," "," "," "," "," "," "," "," "," ","e"," "," "," ","x"],
            ["x"," "," ","x","x","x"," "," "," ","e"," "," "," "," "," "," "," "," "," ","e"," "," "," "," "," "," "," "," "," ","x"],
            ["x"," "," ","x","x","x"," ","e"," "," "," "," "," "," "," "," "," "," "," "," "," ","e"," "," "," "," "," "," "," ","x"],
            ["x"," ","x","x","x","x"," "," ","e"," "," "," "," "," "," "," "," "," "," "," "," "," "," "," "," "," "," "," "," ","x"],
            ["x"," ","x","x","x","x"," "," "," "," "," "," "," "," "," "," "," "," "," "," "," "," "," ","e"," "," "," "," "," ","x"],
            ["x"," ","x","x","x","x"," "," "," "," "," ","e"," "," ","e"," "," "," "," "," "," "," "," "," "," "," "," "," "," ","x"],
            ["x"," "," "," "," "," "," "," ","e"," "," "," "," "," "," "," "," "," "," "," "," "," "," "," "," ","e"," "," "," ","x"],
            ["x"," "," "," "," "," "," "," "," "," "," "," "," "," "," "," "," "," "," "," "," "," "," "," "," "," ","x","x","x","x"],
            ["x"," "," "," "," "," "," "," "," "," "," "," "," "," "," "," "," "," "," "," "," "," "," "," "," "," "," "," "," ","x"],
            ["x"," "," "," "," "," "," "," ","e"," "," "," "," "," "," "," "," "," "," "," "," "," ","e"," "," "," "," "," ","2","x"],
            ["x"," "," ","e"," "," "," "," "," "," "," "," "," "," "," "," "," "," "," "," "," "," "," "," "," "," ","x","x","x","x"],
            ["x"," "," "," "," "," ","e"," "," "," "," "," "," "," "," "," "," "," "," "," "," "," "," "," "," "," "," "," "," ","x"],
            ["x"," "," "," "," "," "," "," "," ","e"," "," "," "," "," "," "," "," "," "," "," "," "," "," "," "," "," "," "," ","x"],
            ["x"," "," "," "," "," "," "," "," "," "," "," "," "," "," "," "," "," "," "," "," "," ","x"," ","e"," "," "," "," ","x"],
            ["x"," ","e"," "," "," "," "," "," "," ","e"," "," "," "," "," "," ","e"," "," "," "," ","x"," "," "," "," "," "," ","x"],
            ["x"," "," "," "," "," "," "," "," "," "," "," "," "," "," "," "," "," "," "," "," "," ","x"," "," "," "," "," "," ","x"],
            ["x"," "," "," "," "," "," "," ","e"," "," "," "," "," "," "," "," "," "," ","e"," "," ","x"," "," "," ","e"," "," ","x"],
            ["x"," "," "," "," "," "," "," "," "," "," "," "," "," "," "," "," "," "," "," "," "," ","x"," "," "," "," "," "," ","x"],
            ["x","x","x","x","x","x","x","x","x","x"," "," "," "," "," ","e"," "," "," "," "," "," ","x"," "," "," "," "," "," ","x"],
            ["x"," "," "," "," "," "," "," "," "," "," "," "," "," "," "," "," "," ","e"," "," "," ","x"," "," "," "," "," "," ","x"],
            ["x"," ","m"," "," "," "," ","e"," "," "," "," "," "," "," "," "," "," "," "," "," "," ","x"," "," "," "," "," "," ","x"],
            ["x"," "," "," "," "," "," "," "," "," "," "," "," "," "," "," "," "," "," "," "," "," ","x"," "," "," "," "," "," ","x"],
            ["x","x","x","x","x","x","x","x","x","x","x","x","x","x","x","x","x","x","x","x","x","x","x","x","x","x","x","x","x","x"]
        ] 
    },
    {
        "level": 2,
        "tile-map": [
            ["x","x","x","x","x","x","x","x","x","x","x","x","x","x","x","x","x","x","x","x","x","x","x","x","x","x","x","x","x","x"],
            ["x"," "," ","x"," ","x","m"," "," "," "," "," "," "," "," ","x"," "," "," "," "," "," "," "," "," "," "," "," "," ","x"],
            ["x"," "," ","x"," ","x"," "," "," "," "," "," "," "," "," ","x"," "," "," "," "," "," "," "," "," "," "," "," "," ","x"],
            ["x"," ","e","x"," ","x"," "," ","s"," "," "," "," "," "," ","x"," "," "," ","e"," "," "," ","s"," "," "," "," "," ","x"],
            ["x"," "," ","x"," ","x"," ","s"," "," "," "," "," "," "," ","x"," "," "," "," "," "," "," "," "," "," "," "," "," ","x"],
            ["x"," "," ","x"," ","x"," "," "," "," "," "," "," "," "," ","x"," "," "," "," "," "," "," "," "," "," "," "," "," ","x"],
            ["x"," "," ","x"," ","x","s","m"," "," "," "," "," "," "," ","x"," "," "," "," "," "," "," "," "," "," "," "," "," ","x"],
            ["x"," "," ","x"," ","x"," "," "," "," "," "," "," "," "," ","x"," "," "," "," "," "," "," "," "," "," "," "," "," ","x"],
            ["x"," "," ","x","x","x","x","x","x","x","x"," "," ","x","x","x"," "," "," "," "," "," "," ","e"," "," "," "," "," ","x"],
            ["x"," "," "," "," "," "," "," "," "," "," "," "," "," "," "," "," "," ","3"," "," "," "," "," "," "," "," ","e"," ","x"],
            ["x"," "," "," "," "," "," "," "," "," "," "," "," "," "," "," "," "," "," "," "," "," "," "," "," "," "," "," "," ","x"],
            ["x"," "," "," "," "," "," "," ","e"," "," "," "," "," "," "," ","e"," "," ","s"," "," "," "," "," "," "," "," "," ","x"],
            ["x"," "," "," "," "," "," "," "," "," "," "," "," "," "," "," "," "," "," "," "," "," "," "," "," "," "," ","e"," ","x"],
            ["x","x","x","x","x"," "," "," "," "," "," "," "," ","s"," "," "," "," "," "," "," "," "," "," "," "," "," "," "," ","x"],
            ["x"," "," "," "," "," "," "," "," "," "," "," "," "," "," "," "," ","e"," "," "," "," "," "," "," "," "," "," "," ","x"],
            ["x","p"," "," "," "," "," "," "," "," "," "," "," "," "," "," "," "," "," "," "," "," "," "," "," "," "," "," "," ","x"],
            ["x"," "," "," ","e"," "," "," "," "," "," ","e"," "," "," "," "," "," "," "," "," "," "," "," "," "," "," "," "," ","x"],
            ["x","x","x","x","x"," "," "," "," "," "," "," "," "," "," "," "," "," "," "," ","e"," "," "," "," "," "," "," "," ","x"],
            ["x"," "," "," "," "," "," ","e"," "," "," "," "," "," "," "," "," "," "," "," "," "," "," "," "," "," "," "," "," ","x"],
            ["x"," "," "," "," "," "," "," "," "," "," "," "," "," "," "," "," "," "," "," "," "," "," ","e"," "," "," "," "," ","x"],
            ["x"," ","e"," "," "," "," ","x"," ","x"," "," "," "," "," "," "," "," "," "," "," ","e"," "," "," "," "," "," "," ","x"],
            ["x"," "," "," "," "," "," ","x"," ","x"," "," "," "," "," "," "," "," "," "," "," "," "," "," "," ","e"," "," "," ","x"],
            ["x"," "," "," "," "," "," ","x"," ","x"," "," "," ","e"," ","s"," "," "," ","e"," "," "," "," ","e"," "," "," "," ","x"],
            ["x"," "," "," "," "," "," ","x"," ","x"," "," "," "," "," "," "," "," "," "," "," "," "," "," "," "," "," "," "," ","x"],
            ["x"," "," "," "," "," "," ","x","m","x"," "," "," "," "," "," "," "," "," "," "," "," "," "," "," "," "," "," "," ","x"],
            ["x","x","x","x","x","x","x","x","x","x","x","x","x","x","x","x","x","x","x","x","x","x","x","x","x","x","x","x","x","x"]
        ] 
    },
    {
        "level": 3,
        "tile-map": [
            ["x","x","x","x","x","x","x","x","x","x","x","x","x","x","x","x","x","x","x","x","x","x","x","x","x","x","x","x","x","x"],
            ["x"," "," ","x"," ","x"," "," "," "," ","f"," "," "," "," ","x"," "," "," "," "," "," "," "," "," "," "," "," "," ","x"],
            ["x","p"," ","x"," ","x"," "," "," "," "," "," "," "," "," ","x"," "," "," "," ","f"," "," "," "," "," "," "," ","x","x"],
            ["x"," "," ","x"," ","x"," "," ","f"," ","f","f","f"," "," ","x"," "," ","f"," "," ","f"," "," "," "," "," "," "," ","x"],
            ["x","f"," ","x"," ","x"," "," "," "," "," "," "," "," "," ","x"," "," "," "," ","f"," "," "," ","f"," "," "," "," ","x"],
            ["x"," "," ","x"," ","x","e"," "," "," ","f"," ","f"," "," ","x"," "," "," "," "," "," ","e"," "," "," "," ","f"," ","x"],
            ["x"," "," ","x"," ","x"," "," ","f"," "," "," "," "," "," ","x"," "," "," "," "," ","f"," "," "," "," "," "," "," ","x"],
            ["x"," ","f","x"," ","x"," ","f"," "," "," "," "," "," "," ","x"," "," ","f"," "," "," "," ","e"," "," "," ","f"," ","x"],
            ["x"," "," ","x"," ","x"," "," ","e"," ","f"," "," "," "," "," "," "," "," ","f"," "," "," "," ","f"," "," "," "," ","x"],
            ["x"," "," ","x","e","m"," "," "," ","f"," "," "," "," "," "," "," "," "," "," "," "," "," ","f","f"," "," "," "," ","x"],
            ["x"," "," ","x"," ","x"," ","f"," "," "," "," "," "," "," "," "," "," "," "," ","f"," "," "," ","f"," "," "," "," ","x"],
            ["x","f"," ","x"," ","x"," "," ","f"," "," "," ","e"," "," "," "," "," ","e"," "," ","e"," "," ","f"," ","f"," "," ","x"],
            ["x"," "," ","x"," ","x"," ","e"," "," ","f"," "," ","f","x","x","x"," "," "," "," "," "," "," ","f"," "," "," "," ","x"],
            ["x","e","f","x"," ","x"," "," "," "," "," "," "," "," "," "," ","x"," "," "," "," ","e"," "," "," "," "," "," "," ","x"],
            ["x"," "," ","x"," ","x"," "," "," ","f"," "," "," ","f"," ","x"," "," ","f","f"," "," "," "," "," "," "," "," "," ","x"],
            ["x"," "," ","x"," ","x"," ","f"," "," ","e"," "," "," ","x"," ","x"," "," "," "," "," "," "," ","f"," "," "," "," ","x"],
            ["x","f"," ","x"," ","x","f"," "," "," "," "," "," "," "," "," "," "," "," "," "," "," "," "," "," "," "," "," "," ","x"],
            ["x"," ","e","x"," ","x"," "," "," "," ","e"," ","e"," "," "," "," "," "," "," "," ","x","x","x","x","x","x","x","x","x"],
            ["x"," "," ","x","e","x"," ","f"," "," "," "," "," ","f"," "," "," "," "," ","e"," "," ","f","f"," "," "," "," "," ","x"],
            ["x"," ","f","x"," ","x"," ","f"," ","f"," "," "," "," "," "," "," "," "," "," "," "," ","f","f"," "," "," "," "," ","x"],
            ["x"," "," ","x"," ","x"," "," "," "," "," ","f"," "," "," "," "," "," ","e"," "," "," ","f","f"," ","m","m"," "," ","x"],
            ["x","f"," ","x"," ","x"," "," "," "," "," "," "," "," "," "," "," "," "," "," "," "," ","f","f"," ","m","m"," "," ","x"],
            ["x"," "," ","x"," ","x"," "," "," "," ","f"," "," "," "," ","f"," "," "," "," "," "," ","f","f"," ","m","m"," "," ","x"],
            ["x"," "," ","f"," ","x"," "," "," "," ","f"," "," "," "," "," "," "," "," "," "," "," ","f","f"," ","m","m"," "," ","x"],
            ["x"," "," ","m"," ","x"," "," "," "," ","f"," "," "," "," "," "," "," "," "," "," "," ","f","f"," "," "," "," "," ","x"],
            ["x","x","x","x","x","x","x","x","x","x","x","x","x","x","x","x","x","x","x","x","x","x","x","x","x","x","x","x","x","x"]
        ] 
    },
    {
        "level": 4,
        "tile-map": [
            ["x","x","x","x","x","x","x","x","x","x","x","x","x","x","x","x","x","x","x","x","x","x","x","x","x","x","x","x","x","x"],
            ["x"," "," ","x"," ","x"," "," "," "," "," "," "," "," "," ","x"," "," "," "," "," "," "," "," "," "," "," "," "," ","x"],
            ["x"," "," ","x"," ","x"," "," "," "," "," "," "," "," "," ","x"," "," "," "," "," "," "," "," "," "," "," "," "," ","x"],
            ["x"," "," ","x"," ","x"," "," "," "," "," "," "," "," "," ","x"," "," "," "," "," "," "," "," "," "," "," "," "," ","x"],
            ["x"," "," ","x"," ","x"," "," "," "," "," "," "," "," "," ","x"," "," "," "," "," "," "," "," "," "," "," "," "," ","x"],
            ["x"," "," ","x"," ","x"," "," "," "," "," "," "," "," "," ","x"," "," "," "," "," "," "," "," "," "," "," "," "," ","x"],
            ["x"," "," ","x"," ","x"," "," "," "," "," "," "," "," "," ","x"," "," "," "," "," "," "," "," "," "," "," "," "," ","x"],
            ["x"," "," ","x"," ","x"," "," "," "," "," "," "," "," "," ","x"," "," "," "," "," "," "," "," "," "," "," "," "," ","x"],
            ["x"," "," ","x","x","x","x","x","x","x","x"," "," ","x","x","x"," "," "," "," "," "," "," "," "," "," "," "," "," ","x"],
            ["x"," "," "," "," "," "," "," "," "," "," "," "," "," "," "," "," "," ","fk"," "," "," "," "," "," "," "," "," "," ","x"],
            ["x"," "," "," "," "," "," "," "," "," "," "," "," "," "," "," "," "," "," "," "," "," "," "," "," "," "," "," "," ","x"],
            ["x"," "," "," "," "," "," "," "," "," "," "," "," "," "," "," "," "," "," "," "," "," "," "," "," "," "," "," "," ","x"],
            ["x"," "," "," "," "," "," "," "," "," "," "," "," "," "," "," "," "," "," "," "," "," "," "," "," "," "," "," "," ","x"],
            ["x"," "," "," "," "," "," "," "," "," "," "," "," "," "," "," "," "," "," "," "," "," "," "," "," "," "," "," "," ","x"],
            ["x"," "," "," "," "," "," "," "," "," "," "," "," "," "," "," "," "," "," "," "," "," "," "," "," "," "," "," "," ","x"],
            ["x"," "," "," "," "," "," "," "," "," "," "," "," "," "," "," "," "," "," "," "," "," "," "," "," "," "," "," "," ","x"],
            ["x"," "," "," "," "," "," "," "," "," "," "," "," "," "," "," "," "," "," "," "," "," "," "," "," "," "," "," "," ","x"],
            ["x"," "," "," "," "," "," "," "," "," "," "," "," "," "," "," "," "," "," "," "," "," "," "," "," "," "," "," "," ","x"],
            ["x"," "," "," "," "," "," "," "," "," "," "," "," "," "," "," "," "," "," "," "," "," "," "," "," "," "," "," "," ","x"],
            ["x"," "," "," "," "," "," "," "," "," "," "," "," "," "," "," "," "," "," "," "," "," "," "," "," "," "," "," "," ","x"],
            ["x"," "," "," "," "," "," "," "," "," "," "," "," "," "," "," "," "," "," "," "," "," "," "," "," "," "," "," "," ","x"],
            ["x"," "," "," "," "," "," "," "," "," "," "," "," "," "," "," "," "," "," "," "," "," "," "," "," "," "," "," "," ","x"],
            ["x"," "," "," "," "," "," "," "," "," "," "," "," "," "," ",""," "," "," "," "," "," "," "," "," "," "," "," "," ","x"],
            ["x"," ","p"," "," "," "," "," "," "," "," "," "," "," "," "," "," "," "," "," "," "," "," "," "," "," "," "," "," ","x"],
            ["x"," "," "," "," "," "," "," "," "," "," "," "," "," "," "," "," "," "," "," "," "," "," "," "," "," "," "," "," ","x"],
            ["x","x","x","x","x","x","x","x","x","x","x","x","x","x","x","x","x","x","x","x","x","x","x","x","x","x","x","x","x","x"]
        ] 
    }
]


